R 640 480
NO ./texture/murt.XPM
SO ./texture/redbrick.XPM
WE ./texture/wood.XPM
EA ./texture/wood.XPM
S ./texture/barrel.XPM

F 220,100,0
C 225,30,0

1 1 1 1 1               111
100011
100011111
11000N001111
1001110001
100000011
100110011111111111
100000000000000001
111111111111000001111
111011111111000S00001
111111111110000001001
111000E00000000111101
111001111111110111101
111001111111110111101
111001111111110111101
111001111111110111101
11100000S0000000W0001
11111111111111111111
