NO ./texture/murt.XPM
SO ./texture/redbrick.XPM
WE ./texture/wood.XPM
EA ./texture/wood.XPM

F 50,50,90
C 1,10,50

111111
100011
100011111
110000001111
1001110001
100000011
100110011111111111
100000000000000001
111111111111000001111
111011111111000S00001
111111111110000001001
111000000000000111101
111001111111110111101
111001111111110111101
111001111111110111101
111001111111110111101
111000000000000000001
111111111111111111111